1111111111111111
1P001100001100E1
1000000000000001
1000110000110001
1111111001111111
1111111001111111
111111C00C111111
1111110000111111
111111C00C111111
1111111111111111