111111111111111111111111111111111
111111110011111111000111110001111
111111110011111111000110110001111
111110010010011111101100011011111
111110000000001111101100010001111
110000000000001110000000000000001
110000000000001110111100010001101
111110000000011110111111111111101
11111111011111111011111C1C1C11101
110111100000000000111110000000001
100011000001111110111110000000001
10000000000111001010001C1C1C11011
100011000001110010001011111111011
110111100011110011100011100111011
111111110111110001110111000011011
111111110111100000100010000000011
111111110111100000000010E00001111
110001110111100000100010000001111
110P00000111110001111111000011111
110001111111110011111111100111111
111111111111111111111111111111111