111111111111111111111111
10000011110P011100011001
10010000000000000C000001
101111111111111100011011
101000110000000110111011
1000C011000E0001101C0001
101000110000000110110001
101111110000000110000001
101000111110111110110001
1000C01111000111101C0001
101000111100011110111101
101111111110111110100001
10100010001011111010CC01
10000000000000000000CC01
101000100010111111100001
101111111110111111111101
100000011110111100000001
10CC01011100011101011101
10CC01000000000001000101
100001111100011111000001
111111111111111111111111