111111111111111111111111111
11100011111100000111100C001
11000H000000001000001100011
100C1C00111100000110100H001
100111001111110111101100011
100C1C001111110111101110111
110000011111000110000000001
110000111111011110111H000H1
110111111111011110111100011
1101111CC010001H00011H00001
1V0011101010101000011100011
100011100010001V000110000H1
100011110111011000011100011
10000HHH0000000000011H00001
10V011110111011101111100011
1000111000100010000110000H1
10001110101010100V001100011
100000100C10C010000C1H00001
100010111111111111111100011
100V1000000E11111111100P001
111111111111111111111111111