111111111111111111
111111111111111111
11P001100001100E11
110000000000000011
110001100001100011
111111110011111111
111111110011111111
1111111C00C1111111
111111100001111111
1111111C00C1111111
111111111111111111
111111111111111111