111111111111111111111111111111111
11111111CC111111110C0111110C01111
11111111001111111100011V110001111
11111001001001111110110V011011111
111110000000HH1111101100010001111
11HHH000000000111000000H000H00001
11HHH0000000001110111100010001101
11111000000HH11110111111111111101
11111111011111111011111C1C1C11101
110111100000000000111110000000001
100011000001111110111110000000001
1C000000000111VV1010001C1C1C11011
10V01100000111VV10001011111111011
11V11110001111VV11100011100111011
1111111101111100V1110111000011011
111111110111100000100010000000011
1111111101111C0000000010E00001111
11000111011110000V100010000001111
110P00000111110001111111000011111
110001111111110011111111100111111
111111111111111111111111111111111