111111111111111111111111111
111000111111000001111000001
110000000000001000001100011
100010001111000001101000001
100111001111110111101100011
100010001111110111101110111
110000011111000110000000001
110000111111011110111000001
110111111111011110111100011
110111100010001000011000001
100011101010101000011100011
100011100010001000011000001
100011110111011000011100011
100000000000000000011000001
100011110111011101111100011
100011100010001000011000001
100011101010101000001100011
100000100010001000001000001
100010111111111111111100011
1000100000001111111110PCE01
111111111111111111111111111