1111111
100P001
1000001
100C001
1000001
100E001
1111111