111111111111111111111111111111111111111
100000000000000000000000000000000000001
111111111111111111111111111111111111111
101110111111111111111111111111101111101
100110111111111111111111111111101111111
101010110001100001110001110001101001101
101100111110101110111110101110100110101
101110110000101110110000101111101110101
101110101110101110101110101110101110101
101110110000101110110000110001101110101
111111111111111111111111111111111111111
1PCCCCCCCCCCCCCCCCCCCCCCCCCCCCCCCCCCCE1
111111111111111111111111111111111111111