1111111111111111111111111111111111111111
1P10000000000000V0V0V0V0V110000VV0000001
101HHHHH00000110V0V0V0V0V11000V00V000101
101HHHHH00000110V0V0V0V0V110000000000101
101HHHHH000001100000000001100V0000V00101
101HHHHH00000110000000000110000000000101
101HHHHH00000110000000000110V000000V0101
101HHHHH0000011V0V0V0V0V0110000000000101
101HHHHH0000011V0V0V0V0V011V00000000V101
100000000000011V0V0V0V0V0000000000000101
1111111111111111111111111111111111111101
1111111111111111111111111111111111111101
1000000000000110000000000000000000000101
101000000000011000000000011H000000V00101
101000000000011000000000011H000000V00101
101000000000011000000000011H000000V00101
101000000000011000000000011H000000V00101
101000000000011000000000011H000000V00101
1C10000000000110000000000110000000000101
1E10000000000000000000000110000000000001
1111111111111111111111111111111111111111