1111111111111111111111111111111111111111
1P10000000000000000000000110000000000001
1010000000000110000000000110000000000101
1010000000000110000000000110000000000101
1010000000000110000000000110000000000101
1010000000000110000000000110000000000101
1010000000000110000000000110000000000101
1010000000000110000000000110000000000101
1010000000000110000000000110000000000101
1000000000000110000000000000000000000101
1111111111111111111111111111111111111101
1111111111111111111111111111111111111101
1000000000000110000000000000000000000101
1010000000000110000000000110000000000101
1010000000000110000000000110000000000101
1010000000000110000000000110000000000101
1010000000000110000000000110000000000101
1010000000000110000000000110000000000101
1C10000000000110000000000110000000000101
1E10000000000000000000000110000000000001
1111111111111111111111111111111111111111